R 640 480 
NO ./images/NO.xpm
SO ./images/SO.xpm 
WE ./images/WE.xpm
EA ./images/EA.xpm
S ./images/ITEM.xpm
F ./images/FLOOR.xpm
C ./images/CEILING.xpm

        1111111111111111111111111
        1000000000000000000000001
        1100000000000000000000001
        1000000000000000000000001
111111111000012100000000000000001
100000002000010100000000000001111
10000000000000N00000002000001
10000110200001111100000000001
10000000000000000100000000001
10000000000000000000000000001
10000000000000000001010000001
11000001110101011111011110101
11110111 1110121 101111010001
11111111 1111111 111111111111
