R 640 480
NO ./images/NO.xpm
SO ./images/SO.xpm 
WE ./images/WE.xpm
EA ./images/EA.xpm
S ./images/ITEM.xpm
F 141,25,37
C 00,153,164

        1111111111111111111111111
        1000000000000000000000001
        1100000000000000000000021
        1000000000000000000000021
111111111000000000000000000000021
100000000000000000000000000001111
10000000000000000000000000021
10000000000000N00000000000021
10000000000000000000000000021
10000000000000000000000000001
10000000000000000001010000001
11000001110101011111011110101
11110111 1110101 101111010001
11111111 1111111 111111111111
